2222222222222200222222222222222222222222222222222222222222222222222222
2555555555555500555555555555555555555555555555555555555555555555555552
2555555555555500555555555555555555555555555555555555555555555555555552
2555555555555500555522222222222222222222222222222225555555555555555552
2555555555555500555525555555555555555555555555555525555555555555555552
2555555555555500555525555555555555555555555555555525555555555555555552
255555555555550055552511111111111SHOP111111111155525555555555555555552
2555555555555500555525188888888888888888888888155525555555555555555552
2555555555555500555525188886888888888888888888155525555555555555555552
2555555555555500555525188888888888888888888888155525555555555555555552
2555555555555500555525188888888888888888888888155525555555555555555552
2555555555555500555525188888888888888888888888155525555555555555555552
2555555555555500555525111111111117711111111111155525555555555555555552
2555555555555500555555555555555550055555555555555555555555555555555552
0000000000000000000000000000055550055555555555555555555555555555555552
0000000000000000000000000000055550055555555555555555555555555555555552
2555555555555500555555555550055550055555555555555555555555555555555552
2555555555555500555555555550000000000000000000000000000000000000000003
2555555555555500555555555550000000000000000000000000000000000000000003
2555555555555500555555555555555555555555555555555555555555555555555552
2555555555555500555555555555555555555555555555555555555555555555555552
2555555555555500555555555555555555555999999999995555555555555555555552
2555555555555500555555555555555555599999999999999555555555555555555552
2555555555555500555555555555555555599999999999999555555555555555555552
2555555555555500555555555555555555599999999999999555555555555555555552
2555555555555500555555555555555555559999999999995555555555555555555552
2555555555555500555555555555555555555559999999555555555555555555555552
2555555555555500555555555555555555555555555555555555555555555555555552
2555555555555500555555555555555555555555555555555555555555555555555552
2222222222222233222222222222222222222222222222222222222222222222222222
