2222222222222233222222222222222222222222222222222222222222222222222222
2555555555555500555555555555555555555555555555555555555555555555555552
2555555555555500555555555555555555555555555555555555555555555555555552
2555555555555500555555555555555555555555555555555555555555555555555552
2555555555555500555555555555555555555555555555555555555555555555555552
2555555555555500555555555555555559995555555555555555555555555555555552
2555555555555500555555555555555999999955555555555555555555555555555552
2555555555555500555555599999999999999999999995555555555555555555555552
2555559555555500555555999999999999999999999999955555555555555555555552
2555599955555500555555999999999999999999999999955555555555555555555552
2555999995555500555555999999999999999999999999955555555555555555555552
2555599955555500555555599999999999999999999999555555555555555555555552
2555559555555500555555555555559999999995555555555555555555555555555552
2555555555555500555555555555555559955555555555555555555555555555555552
2555555555555500000000000000055555555555555555555555555555555555555552
2555555555555500000000000000055555555555555555555555555555555555555552
2555555555555500555555555550055555555555555555555555555555555555555552
2555555555555500555555555550000000000000000000000000000000000000000002
2555555555555500555555555550000000000000000000000000000000000000000002
2555555555555500555555555555555555555555555555555555555555555555555552
2555555555555500555555555555555555555555555555555555555555555555555552
2555555555555500555555555555555555555999999999995555555555555555555552
2555555555555500555555555555555555599999999999999555555555555555555552
2555555555555500555555555555555555599999999999999555555555555555555552
2555555555555500555555555555555555599999999999999555555555555555555552
2555555555555500555555555555555555559999999999995555555555555555555552
2555555555555500555555555555555555555559999999555555555555555555555552
2555555555555500555555555555555555555555555555555555555555555555555552
2555555555555500555555555555555555555555555555555555555555555555555552
2222222222222222222222222222222222222222222222222222222222222222222222