2222222222222222222222222222222222222222222222222222222222222222222222
25511111111111SHOP1111111111555555555555555555555555555555555555555552
2551888888888888888888888881555555555555555555555555555555555555555552
2551888868888888888888888881555555555555555555555555555555555555555552
2551888888888888888888888881555555555555555555555555555555555555555552
2551888888888888888888888881555555555555555555555555555555555555555552
2551888888888888888888888881555555555555555555555555555555555555555552
2551111111111177111111111111555555555555555555555555555555555555555552
2555555555555500555555555555555555555555555555555555555555555555555552
2555555555555500555555555555555555555555555555555555555555555555555552
2555555555555500000000000000055555555555555555555555555555555555555552
2555555555555500000000000000055555555555555555555555555555555555555552
2555555555555500555555555550055555555555555555555555555555555555555552
2555555555555500555555555550055555555555555555555555555555555555555552
0000000000000000000000000000055555555555555555555555555555555555555552
0000000000000000000000000000055555555555555555555555555555555555555552
2555555555555500555555555550055555555555555555555555555555555555555552
2555555555555500555555555550000000000000000000000000000000000000000003
2555555555555500555555555550000000000000000000000000000000000000000003
2555555555555500555555555555555555555555555555555555555555555555555552
2555555555555500555555555555555555555555555555555555555555555555555552
2555555555555500555555555555555555555555555555555555555555555555555552
2999999999999900999999999999999999999999999999999999999999999999999992
2999999999999900999999999999999999999999999999999999999999999999999992
2999999999999900999999999999999999999999999999999999999999999999999992
2555555555555500555555555555555555555555555555555555555555555555555552
2555555555555500555555555555555555555555555555555555555555555555555552
2555555555555500555555555555555555555555555555555555555555555555555552
2555555555555500555555555555555555555555555555555555555555555555555552
2222222222222233222222222222222222222222222222222222222222222222222222
